---------这是 prefab中存在, 但是excel中没有配置的项
DlgGameMode/EGBackGround/E_ARRoomModeCreate/E_ARRoomModeCreateText	AR创建房间
DlgGameMode/EGBackGround/E_ARRoomModeJoin/E_ARRoomModeJoinText	AR加入


---------这是 excel配置,但是不存在prefab中的项
DlgBattleTower/E_PutHomeAndMonsterPoint/EButton_PutHome/ELabel_PutHome	放置大本营
DlgBattleTower/E_Battle/E_TowerBuyShow/EButton_BuyClose/ELabel_BuyClose	收起
DlgBattleTowerBegin/E_Effect/Effect_GameBegin/EButton_GameBegin/final (1)	游戏开始
DlgBattleTowerHUD/E_OperatorMenu/Image/E_TowerName	火焰塔
DlgCommonConfirm/EGBackGround/Root/EG_Confirm/E_ConfirmCancel/Text	取消
DlgCommonConfirm/EGBackGround/Root/EG_Confirm/E_ConfirmSure/Text	确定
DlgCommonConfirm/EGBackGround/Root/EG_Sure/E_Sure/Text	确定
DlgCommonConfirm/EGBackGround/Root/EG_title/title	提示
DlgGameMode/EGBackGround/E_ARRoomMode/E_ARRoomModeText	AR房间模式
DlgRoom/EGBackGround/E_QuitRoom/Text	退出房间
Canvas (Environment)/Item_Room/ELabel_Content	滑动列表项
Canvas (Environment)/Item_RoomMember/ELabel_Content_Name	名称
Canvas (Environment)/Item_RoomMember/EButton_Operator/ELabel_Operator	操作
Canvas (Environment)/Item_Tower/ELabel_Name	idsuhciud哈哈哈12
DlgGameModeAR/E_HomePage/E_Avatar/E_PlayerName	玩家名称123
DlgLogin/Sprite_BackGround/E_Login_google/Text	谷歌账号登录
DlgBattleTower/E_PutHomeAndMonsterPoint/EButton_PutHome/ELabel_PutHome01	放置大本营
DlgBattleTower/E_PutHomeAndMonsterPoint/EButton_PutMonsterPoint/ELabel_PutMonsterPoint_01	放置出怪口
DlgBattleTower/E_Battle/ELabel_LeftMonsterWave01	波数 {0}/{1}
DlgBattleTower/E_Battle/ELabel_LeftTime01	下波开始时间
DlgBattleTower/E_Battle/E_TowerBuyShow/EButton_Refresh/ELabel_Refresh01	{0}
DlgBattleTower/E_Battle/E_LeftCallPlayerTowerCount01	还可放置{0}个防御塔
DlgBattleTowerAR/E_PutHomeAndMonsterPoint/EButton_PutHome/ELabel_PutHome01	放置大本营
DlgBattleTowerAR/E_PutHomeAndMonsterPoint/EButton_PutMonsterPoint/ELabel_PutMonsterPoint_01	放置出怪口
DlgBattleTowerAR/E_Battle/GameObject/ELabel_TotalGold_01	{0}
DlgBattleTowerAR/E_Battle/ELabel_LeftMonsterWave01	波数 {0}/{1}
DlgBattleTowerAR/E_Battle/ELabel_LeftTime01	下波开始时间
DlgBattleTowerAR/E_Battle/E_TowerBuyShow/EButton_Refresh/ELabel_Refresh01	{0}
DlgBattleTowerAR/E_Battle/E_TowerBuyShow/Text (TMP)	获得防御塔
DlgBattleTowerAR/E_Battle/E_LeftCallPlayerTowerCount01	还可放置{0}个防御塔
DlgLogin/Sprite_BackGround/E_SwitchPlayer/Text	切换用户
DlgBattleTowerAR/E_Battle/E_TowerBuyShow/EButton_Refresh/ELabel_Refresh	{0}
